仰望 - 法老 / 魏允熙
冷战 - TizzyT / Vinida (万妮达)
下雨天 - KnowKnow
都市霓虹 - SFNT / TizzyT / CHOCKEY有三 / HEAT J / Crazy C
Mr. Right - 布瑞吉Bridge / DP龙猪
安全感 - YOUNG
P.Y.T - 马思唯 / 艾志恒Asen
必杀技 - 满舒克 / Wiz_H张子豪 / 小春Kenzy
小镇爱（Thug Love） - 艾志恒Asen / 付思遥
插叙人生（Montage） - Y.Z.H / 李晨曦Chrisulous
旅行家的忠诚 - 黄旭 / 艾热 AIR
C级浪漫 - 法老 / 邓典果DDG / KnowKnow
驯服 - NINEONE#赵馨玥
沛公 - FOX胡天渝
温柔乡，屠宰场 - Ty. / 艾维斯EVIS / 斑比Bambii
I Am Hip Hop - 王以太
Cfbdsir2149 - 周夏影 / 法老
和影子跳舞 (feat. 毛不易) - VaVa毛衍七 / 毛不易
WHO'S NEXT - 黄旭 / 李佳隆
舍曲林 - AY楊佬叁 / 西奥Sio
DIDA滴嗒 - Vinida (万妮达)
某某 - ICE杨长青 / J. Sheon
天空慢慢变暗 - 黄旭 / step.jad依加
百氚朝海 - 若什么浅 / LSC. / Rezey
23 - 艾志恒Asen
POW!! - 黄旭 / 杨和苏KeyNG / VaVa毛衍七
一家人 - 大渊MUTA / TangoZ / 艾福杰尼 / 派克特（PACT） / 盛宇D-SHINE
牧之 - FOX胡天渝
Bully - 幼稚园杀手
不再等你 - Mikey-18 / Lil Puff / 哨孟定
馈赠 - Lambert凌
海边探戈 - 王鹤棣 / 王齐铭WatchMe / 朴鲨VPS
下不完的雨 - 刘思鉴
城市孤独病 - 姜云升
离开 - Vico
杜鹃 - 李佳隆
黑色星期五 - 马思唯 / 艾志恒Asen
直播带货 - AR刘夫阳 / 法老
神明 - NINEONE#赵馨玥
这般雨天 - 某幻君
夏天的烟火 - LZ轮子 / P-DFRT / BALLINLAB
海誓山盟 - 巴音汗 / 洛尘鞅_
我只能离开 - 刘思达LOFTHESTAR
门槛 - Lambert凌
怪就怪天气 - OneOne / xxxmiracle / Zy
中二没有病 - 张颜齐
N9“天使” - BOBBYNOPEACE / Lil Asian
想你的夜 - LZ轮子 / BALLINLAB
我的歌声里 - Pslow
Strangers - Spylent / 法老
丹阳子（道诡异仙同人曲） - Ofo凌四
Reverse - ljz329 / YOUNG / 谢帝
我想 (remix) (LIVE版) - 法老
如果可以我想和你 - xxxmiracle / Mikey-18
嘴脸 - Bo Peep
怎么忘记 - 前男友 / 袁小葳
爱变质 - Mikey-18 / xxxmiracle
林宛瑜 - Rapeter
下坠Falling - Corki刘宗鑫 / SipSu小口酥
零点都市 - ICE杨长青
六月的雨 - 刘大拿 / 刘兆宇
La Haine - FAC-D12 / SouthSideSamurai / 九维
底牌 - Capper / mac ova seas / 郭采洁
Babe - 马思唯 / 艾志恒Asen / 罗言
末日 - 王子明